
1;1;1;1;1;3;2;39;47;47;23;2;2;2;2;4;1;1;1;1;1;1;1;1;1;1;1;1;1;1;1;1;1;1;1;1;1;1;1;1;1;9;2;2;15;47;47;47;47;47;
1;1;1;1;1;1;3;2;39;47;47;23;2;2;2;2;4;1;1;1;1;1;1;1;1;1;1;1;1;1;1;1;1;1;1;1;1;1;1;1;9;2;2;15;47;47;47;47;47;47;
1;1;1;1;1;1;1;3;2;39;47;47;47;23;2;2;2;4;1;1;1;1;1;1;1;1;1;1;1;1;1;1;1;1;1;1;1;1;1;9;2;2;2;47;47;47;47;47;47;31;
1;1;1;1;1;1;1;1;3;2;39;47;47;47;23;2;2;2;4;1;1;1;1;1;1;1;1;1;1;1;1;1;1;1;1;1;1;1;9;2;2;2;15;47;47;47;47;47;31;2;
1;1;1;1;1;1;1;1;1;3;2;2;39;47;47;47;23;2;2;2;4;1;1;1;1;1;1;1;1;1;1;1;1;1;1;1;1;9;2;2;2;15;47;47;47;47;47;31;2;2;
1;1;1;1;1;1;1;1;1;1;1;3;2;2;39;47;47;23;2;2;2;4;1;1;1;1;1;1;1;1;1;1;1;1;1;1;1;2;2;2;15;47;47;47;47;31;2;2;2;2;
1;1;1;1;1;1;1;1;1;1;1;1;1;3;2;39;47;47;23;2;2;2;4;1;1;1;1;1;1;1;1;1;1;1;1;1;9;2;2;15;47;47;47;47;31;2;2;2;2;2;
1;1;1;1;1;1;1;1;1;1;1;1;1;1;3;2;39;47;47;23;2;2;2;4;1;1;1;1;1;1;1;1;1;1;1;9;2;2;15;47;47;47;47;31;2;2;10;1;1;3;
1;1;1;1;1;1;1;1;1;1;1;1;1;1;1;3;2;39;47;47;23;2;2;2;1;1;1;1;1;1;1;1;1;1;1;2;2;2;47;47;47;47;31;2;2;10;1;1;1;1;
1;1;1;1;1;1;1;1;1;1;1;1;1;1;1;1;3;2;39;47;47;23;2;2;4;1;1;1;1;1;1;1;1;1;1;2;2;15;47;47;47;31;2;2;10;1;1;1;1;1;
1;1;1;1;1;1;1;1;1;1;1;1;1;1;1;1;1;3;2;39;47;47;23;2;2;4;1;1;1;1;1;1;1;1;9;2;2;47;47;47;31;2;2;10;1;1;1;1;1;1;
1;1;1;1;1;1;1;1;1;1;1;1;1;1;1;1;1;1;3;2;39;47;47;23;2;2;2;2;2;2;4;1;1;9;2;2;15;47;47;47;2;2;10;1;1;1;1;1;1;1;
1;1;1;1;1;1;1;1;1;1;1;1;1;1;1;1;1;1;1;3;2;39;47;47;23;2;2;2;2;2;2;2;2;2;2;2;47;47;47;47;2;2;1;1;1;1;1;1;1;1;
1;1;1;1;1;1;1;1;1;1;1;1;1;1;1;1;1;1;1;1;3;2;39;47;47;47;47;47;47;23;2;2;2;2;2;15;47;47;47;47;2;2;1;1;1;1;1;1;1;1;
1;1;1;1;1;1;1;1;1;1;1;1;1;1;1;1;1;1;1;1;1;3;2;39;47;47;47;47;47;47;47;47;23;2;15;47;47;47;47;47;2;2;4;1;1;1;1;1;1;1;
1;1;1;1;1;1;1;1;1;1;1;1;1;1;1;1;1;1;1;1;1;1;3;2;2;2;2;39;47;47;47;47;47;47;47;47;47;47;47;47;2;2;2;1;1;1;1;1;1;1;
1;1;1;1;1;1;1;1;1;1;1;1;1;1;1;1;1;1;1;1;1;1;1;1;3;2;2;2;2;2;2;2;39;47;47;47;47;47;47;47;2;2;2;1;1;1;1;1;1;1;
4;1;1;1;1;1;1;1;1;1;1;1;1;1;1;1;1;1;1;1;1;1;1;1;1;1;1;1;1;3;2;2;2;2;2;39;47;47;47;47;2;2;2;1;1;1;1;1;1;1;
2;4;1;1;1;1;1;1;1;1;1;1;1;1;1;1;1;1;1;1;1;1;1;1;1;1;1;1;1;1;1;3;2;2;2;2;47;47;47;47;23;2;2;1;1;1;1;1;1;1;
2;2;4;1;1;1;1;1;1;1;1;1;1;1;1;1;1;1;1;1;1;1;1;1;1;1;1;1;1;1;1;1;3;2;2;2;47;47;47;47;47;2;2;1;1;1;1;1;1;1;
2;2;2;4;1;1;1;1;1;1;1;1;1;1;1;1;1;1;1;1;1;1;1;1;1;1;1;1;1;1;1;1;1;3;2;2;47;47;47;47;47;2;2;1;1;1;1;1;1;1;
2;2;2;2;4;1;1;1;1;1;1;1;1;1;1;1;1;1;1;1;1;1;1;1;1;1;1;1;1;1;1;1;1;1;2;2;47;47;47;47;47;2;2;1;1;1;1;1;1;1;
2;2;2;2;2;4;1;1;1;1;1;1;1;1;1;1;1;1;1;1;1;1;1;1;1;1;1;1;1;1;1;1;1;1;2;2;47;47;47;47;47;2;2;1;1;1;1;1;1;1;
6;2;2;2;2;2;4;1;1;1;1;1;1;1;1;1;1;1;1;1;1;1;1;1;1;1;1;1;1;1;1;1;1;9;2;2;47;47;47;47;31;2;2;1;1;1;1;1;1;1;
5;5;6;2;2;2;2;4;1;1;1;1;1;1;1;1;1;1;1;1;1;1;1;1;1;1;1;1;1;1;1;1;1;2;2;2;47;47;47;47;2;2;2;1;1;1;1;1;1;1;
5;5;5;6;2;2;2;2;4;1;1;1;1;1;1;1;1;1;1;1;1;1;1;1;1;1;1;1;1;1;1;1;9;2;2;15;47;47;47;47;2;2;10;1;1;1;1;1;1;1;
5;5;5;5;6;2;2;2;2;4;1;1;1;1;1;1;1;1;1;1;1;1;1;1;1;1;1;1;1;1;1;9;2;2;15;47;47;47;47;31;2;2;1;1;1;1;1;1;1;1;
5;5;5;5;5;6;2;2;2;2;2;2;4;1;1;1;1;1;1;1;1;1;1;1;1;1;1;1;1;1;9;2;2;15;47;47;47;47;47;2;2;2;1;1;1;1;1;1;1;1;
5;5;5;5;5;5;5;6;2;2;2;2;2;2;2;4;1;1;1;1;1;1;1;1;1;1;1;1;1;9;2;2;2;47;47;47;47;47;31;2;2;2;1;1;1;1;1;1;1;1;
5;5;5;5;5;5;5;5;6;2;2;2;2;2;2;2;2;2;2;2;2;2;2;4;1;1;1;9;2;2;2;2;15;47;47;47;47;31;2;2;2;10;1;1;1;1;1;1;1;1;
11;5;5;5;5;5;5;5;5;5;6;2;2;2;2;2;2;2;2;2;2;2;2;2;2;2;2;2;2;2;2;15;47;47;47;47;31;2;2;2;10;1;1;1;1;1;1;1;1;1;
47;47;11;5;5;5;5;5;5;5;5;6;2;2;2;2;2;2;2;2;2;2;2;2;2;2;2;2;2;2;15;47;47;47;47;31;2;2;2;10;1;1;1;1;1;1;1;1;1;1;
47;47;47;47;11;5;5;5;5;5;5;5;5;5;6;2;2;2;2;2;2;2;2;2;2;7;5;5;6;15;47;47;47;47;31;2;2;2;10;1;1;1;1;1;1;1;1;1;1;1;
47;47;47;47;47;11;5;5;5;5;5;5;5;5;5;5;5;5;5;5;5;5;5;5;5;5;5;5;13;47;47;47;47;31;2;2;2;10;1;1;1;1;1;1;1;1;1;1;1;1;
47;47;47;47;47;47;47;11;5;5;5;5;5;5;5;5;5;5;5;5;5;5;5;5;5;5;5;13;47;47;47;47;14;6;2;2;2;1;1;1;1;1;1;1;1;1;1;1;1;1;
47;47;47;47;47;47;47;47;47;11;5;5;5;5;5;5;5;5;5;5;5;5;5;5;5;5;13;47;47;47;47;14;5;5;2;2;10;1;1;1;1;1;1;1;1;1;1;1;1;1;
47;47;47;47;47;47;47;47;47;47;47;47;11;5;5;5;5;5;5;5;5;5;5;5;5;13;47;47;47;47;14;5;5;5;2;2;1;1;1;1;1;1;1;1;1;1;1;1;1;1;
47;47;47;47;47;47;47;47;47;47;47;47;47;11;5;5;5;5;5;5;5;5;5;5;13;47;47;47;47;14;5;5;5;8;2;2;1;1;1;1;1;1;1;1;1;1;1;1;1;1;
47;47;47;47;47;47;47;47;47;47;47;47;47;47;47;11;5;5;5;5;5;5;13;47;47;47;47;47;14;5;5;5;8;2;2;2;1;1;1;1;1;1;1;1;1;1;1;1;1;1;
47;47;47;47;47;47;47;47;47;47;47;47;47;47;47;47;47;47;47;47;47;47;47;47;47;47;47;14;5;5;5;5;2;2;2;10;1;1;1;1;1;1;1;1;1;1;1;1;1;1;
47;47;47;47;47;47;47;47;47;47;47;47;47;47;47;47;47;47;47;47;47;47;47;47;47;47;47;5;5;5;5;5;2;2;2;4;1;1;1;1;1;1;1;1;1;1;1;1;1;1;
47;47;47;47;47;47;47;47;47;47;47;47;47;47;47;47;47;47;47;47;47;47;47;47;47;47;14;5;5;5;5;5;6;2;2;2;1;1;1;1;1;1;1;1;1;1;1;1;1;1;
47;47;47;47;47;47;47;47;47;47;47;47;47;47;47;47;47;47;47;47;47;47;47;47;47;47;5;5;5;5;5;5;5;6;2;2;1;1;1;1;1;1;1;1;1;1;1;1;1;1;
47;47;47;47;47;47;47;47;47;47;47;47;47;47;47;47;47;47;47;47;47;47;47;47;47;47;5;5;5;5;5;5;5;5;2;2;4;1;1;1;1;1;1;1;1;1;1;1;1;1;
47;47;47;47;47;47;47;47;47;47;47;47;47;47;47;47;47;47;47;47;47;47;47;47;47;47;11;5;5;5;5;5;5;5;2;2;2;1;1;1;1;1;1;1;1;1;1;1;1;1;
47;47;47;47;47;47;47;47;47;47;47;47;47;47;47;47;47;47;47;47;47;47;47;47;47;47;47;5;5;5;5;5;5;5;6;2;2;1;1;1;1;1;1;1;1;1;1;1;1;1;
47;47;47;47;47;47;47;47;47;47;47;47;47;47;47;47;47;47;47;47;47;47;47;47;47;47;47;11;5;5;5;5;5;5;5;2;2;4;1;1;1;1;1;1;1;1;1;1;1;1;
47;47;47;47;47;47;47;47;47;47;47;47;47;47;47;47;47;47;47;47;47;47;47;47;47;47;47;47;5;5;5;5;5;5;5;2;2;2;1;1;1;1;1;1;1;1;1;1;1;1;
47;47;47;47;47;47;47;47;47;47;47;47;47;47;47;47;47;47;47;47;47;47;47;47;47;47;47;47;11;5;5;5;5;5;5;6;2;2;4;1;1;1;1;1;1;1;1;1;1;1;
47;47;47;47;47;47;47;47;47;47;47;47;47;47;47;47;47;47;47;47;47;47;47;47;47;47;47;47;47;47;11;5;5;5;5;5;2;2;2;4;1;1;1;1;1;1;1;1;1;1
