2;1;1;1;1;3;2;2;11;11;11;2;2;2;2;4;1;1;1;1;1;1;1;1;1;1;1;1;1;1;1;1;1;1;1;1;1;1;1;1;1;9;2;2;11;11;11;11;11;11;
1;1;1;1;1;1;3;2;2;11;11;11;2;2;2;2;4;1;1;1;1;1;1;1;1;1;1;1;1;1;1;1;1;1;1;1;1;1;1;1;9;2;2;11;11;11;11;11;11;11;
1;1;1;1;1;1;1;3;2;2;11;11;11;2;2;2;2;4;1;1;1;1;1;1;1;1;1;1;1;1;1;1;1;1;1;1;1;1;1;9;2;2;2;11;11;11;11;11;11;2;
1;1;1;1;1;1;1;1;3;2;2;11;11;11;11;2;2;2;4;1;1;1;1;1;1;1;1;1;1;1;1;1;1;1;1;1;1;1;9;2;2;2;11;11;11;11;11;11;11;2;
1;1;1;1;1;1;1;1;1;3;2;2;2;11;11;11;11;2;2;2;4;1;1;1;1;1;1;1;1;1;1;1;1;1;1;1;1;9;2;2;2;11;11;11;11;11;11;11;2;2;
1;1;1;1;1;1;1;1;1;1;1;3;2;2;2;11;11;11;2;2;2;4;1;1;1;1;1;1;1;1;1;1;1;1;1;1;1;2;2;2;11;11;11;11;11;2;2;2;2;2;
1;1;1;1;1;1;1;1;1;1;1;1;1;3;2;2;11;11;11;2;2;2;4;1;1;1;1;1;1;1;1;1;1;1;1;1;9;2;2;11;11;11;11;11;2;2;2;2;2;2;
1;1;1;1;1;1;1;1;1;1;1;1;1;1;3;2;2;11;11;11;2;2;2;4;1;1;1;1;1;1;1;1;1;1;1;9;2;2;11;11;11;11;11;2;2;2;10;1;1;3;
1;1;1;1;1;1;1;1;1;1;1;1;1;1;1;3;2;2;11;11;11;2;2;2;1;1;1;1;1;1;1;1;1;1;1;2;2;2;11;11;11;11;2;2;2;10;1;1;1;1;
1;1;1;1;1;1;1;1;1;1;1;1;1;1;1;1;3;2;2;11;11;11;2;2;4;1;1;1;1;1;1;1;1;1;1;2;2;11;11;11;11;2;2;2;10;1;1;1;1;1;
1;1;1;1;1;1;1;1;1;1;1;1;1;1;1;1;1;3;2;2;11;11;11;2;2;4;1;1;1;1;1;1;1;1;9;2;2;11;11;11;2;2;2;10;1;1;1;1;1;1;
1;1;1;1;1;1;1;1;1;1;1;1;1;1;1;1;1;1;3;2;2;11;11;2;2;2;2;2;2;2;4;1;1;9;2;2;11;11;11;11;2;2;10;1;1;1;1;1;1;1;
1;1;1;1;1;1;1;1;1;1;1;1;1;1;1;1;1;1;1;3;2;2;11;11;2;2;2;2;2;2;2;2;2;2;2;2;11;11;11;11;2;2;1;1;1;1;1;1;1;1;
1;1;1;1;1;1;1;1;1;1;1;1;1;1;1;1;1;1;1;1;3;2;2;11;11;11;11;11;11;2;2;2;2;2;2;11;11;11;11;11;2;2;1;1;1;1;1;1;1;1;
1;1;1;1;1;1;1;1;1;1;1;1;1;1;1;1;1;1;1;1;1;3;2;2;11;11;11;11;11;11;11;11;2;2;2;11;11;11;11;11;2;2;4;1;1;1;1;1;1;1;
1;1;1;1;1;1;1;1;1;1;1;1;1;1;1;1;1;1;1;1;1;1;3;2;2;2;2;2;11;11;11;11;11;11;11;11;11;11;11;11;2;2;2;1;1;1;1;1;1;1;
1;1;1;1;1;1;1;1;1;1;1;1;1;1;1;1;1;1;1;1;1;1;1;1;3;2;2;2;2;2;2;2;2;11;11;11;11;11;11;11;2;2;2;1;1;1;1;1;1;1;
4;1;1;1;1;1;1;1;1;1;1;1;1;1;1;1;1;1;1;1;1;1;1;1;1;1;1;1;1;3;2;2;2;2;2;2;11;11;11;11;2;2;2;1;1;1;1;1;1;1;
2;4;1;1;1;1;1;1;1;1;1;1;1;1;1;1;1;1;1;1;1;1;1;1;1;1;1;1;1;1;1;3;2;2;2;2;11;11;11;11;11;2;2;1;1;1;1;1;1;1;
2;2;4;1;1;1;1;1;1;1;1;1;1;1;1;1;1;1;1;1;1;1;1;1;1;1;1;1;1;1;1;1;3;2;2;2;11;11;11;11;11;2;2;1;1;1;1;1;1;1;
2;2;2;4;1;1;1;1;1;1;1;1;1;1;1;1;1;1;1;1;1;1;1;1;1;1;1;1;1;1;1;1;1;3;2;2;11;11;11;11;11;2;2;1;1;1;1;1;1;1;
2;2;2;2;4;1;1;1;1;1;1;1;1;1;1;1;1;1;1;1;1;1;1;1;1;1;1;1;1;1;1;1;1;1;2;2;11;11;11;11;11;2;2;1;1;1;1;1;1;1;
2;2;2;2;2;4;1;1;1;1;1;1;1;1;1;1;1;1;1;1;1;1;1;1;1;1;1;1;1;1;1;1;1;1;2;2;11;11;11;11;11;2;2;1;1;1;1;1;1;1;
6;2;2;2;2;2;4;1;1;1;1;1;1;1;1;1;1;1;1;1;1;1;1;1;1;1;1;1;1;1;1;1;1;9;2;2;11;11;11;11;2;2;2;1;1;1;1;1;1;1;
5;5;6;2;2;2;2;4;1;1;1;1;1;1;1;1;1;1;1;1;1;1;1;1;1;1;1;1;1;1;1;1;1;2;2;2;11;11;11;11;2;2;2;1;1;1;1;1;1;1;
5;5;5;6;2;2;2;2;4;1;1;1;1;1;1;1;1;1;1;1;1;1;1;1;1;1;1;1;1;1;1;1;9;2;2;11;11;11;11;11;2;2;10;1;1;1;1;1;1;1;
5;5;5;5;6;2;2;2;2;4;1;1;1;1;1;1;1;1;1;1;1;1;1;1;1;1;1;1;1;1;1;9;2;2;2;11;11;11;11;2;2;2;1;1;1;1;1;1;1;1;
5;5;5;5;5;6;2;2;2;2;2;2;4;1;1;1;1;1;1;1;1;1;1;1;1;1;1;1;1;1;9;2;2;2;11;11;11;11;11;2;2;2;1;1;1;1;1;1;1;1;
5;5;5;5;5;5;5;6;2;2;2;2;2;2;2;4;1;1;1;1;1;1;1;1;1;1;1;1;1;9;2;2;2;11;11;11;11;11;2;2;2;2;1;1;1;1;1;1;1;1;
5;5;5;5;5;5;5;5;6;2;2;2;2;2;2;2;2;2;2;2;2;2;2;4;1;1;1;9;2;2;2;2;2;11;11;11;11;2;2;2;2;10;1;1;1;1;1;1;1;1;
11;5;5;5;5;5;5;5;5;5;6;2;2;2;2;2;2;2;2;2;2;2;2;2;2;2;2;2;2;2;2;2;11;11;11;11;2;2;2;2;10;1;1;1;1;1;1;1;1;1;
11;11;11;5;5;5;5;5;5;5;5;6;2;2;2;2;2;2;2;2;2;2;2;2;2;2;2;2;2;2;11;11;11;11;11;2;2;2;2;10;1;1;1;1;1;1;1;1;1;1;
11;11;11;11;11;5;5;5;5;5;5;5;5;5;6;2;2;2;2;2;2;2;2;2;2;7;5;5;6;11;11;11;11;11;11;2;2;2;10;1;1;1;1;1;1;1;1;1;1;1;
11;11;11;11;11;11;5;5;5;5;5;5;5;5;5;5;5;5;5;5;5;5;5;5;5;5;5;5;11;11;11;11;11;2;2;2;2;10;1;1;1;1;1;1;1;1;1;1;1;1;
11;11;11;11;11;11;11;11;5;5;5;5;5;5;5;5;5;5;5;5;5;5;5;5;5;5;5;11;11;11;11;11;11;6;2;2;2;1;1;1;1;1;1;1;1;1;1;1;1;1;
11;11;11;11;11;11;11;11;11;11;5;5;5;5;5;5;5;5;5;5;5;5;5;5;5;5;11;11;11;11;11;11;5;5;2;2;10;1;1;1;1;1;1;1;1;1;1;1;1;1;
11;11;11;11;11;11;11;11;11;11;11;11;11;5;5;5;5;5;5;5;5;5;5;5;5;5;11;11;11;11;11;5;5;5;2;2;1;1;1;1;1;1;1;1;1;1;1;1;1;1;
11;11;11;11;11;11;11;11;11;11;11;11;11;11;5;5;5;5;5;5;5;5;5;5;11;11;11;11;11;5;5;5;5;8;2;2;1;1;1;1;1;1;1;1;1;1;1;1;1;1;
11;11;11;11;11;11;11;11;11;11;11;11;11;11;11;11;5;5;5;5;5;5;11;11;11;11;11;11;11;5;5;5;8;2;2;2;1;1;1;1;1;1;1;1;1;1;1;1;1;1;
11;11;11;11;11;11;11;11;11;11;11;11;11;11;11;11;11;11;11;11;11;11;11;11;11;11;11;11;5;5;5;5;2;2;2;10;1;1;1;1;1;1;1;1;1;1;1;1;1;1;
11;11;11;11;11;11;11;11;11;11;11;11;11;11;11;11;11;11;11;11;11;11;11;11;11;11;11;5;5;5;5;5;2;2;2;4;1;1;1;1;1;1;1;1;1;1;1;1;1;1;
11;11;11;11;11;11;11;11;11;11;11;11;11;11;11;11;11;11;11;11;11;11;11;11;11;11;11;5;5;5;5;5;6;2;2;2;1;1;1;1;1;1;1;1;1;1;1;1;1;1;
11;11;11;11;11;11;11;11;11;11;11;11;11;11;11;11;11;11;11;11;11;11;11;11;11;11;5;5;5;5;5;5;5;6;2;2;1;1;1;1;1;1;1;1;1;1;1;1;1;1;
11;11;11;11;11;11;11;11;11;11;11;11;11;11;11;11;11;11;11;11;11;11;11;11;11;11;5;5;5;5;5;5;5;5;2;2;4;1;1;1;1;1;1;1;1;1;1;1;1;1;
11;11;11;11;11;11;11;11;11;11;11;11;11;11;11;11;11;11;11;11;11;11;11;11;11;11;11;5;5;5;5;5;5;5;2;2;2;1;1;1;1;1;1;1;1;1;1;1;1;1;
11;11;11;11;11;11;11;11;11;11;11;11;11;11;11;11;11;11;11;11;11;11;11;11;11;11;11;5;5;5;5;5;5;5;6;2;2;1;1;1;1;1;1;1;1;1;1;1;1;1;
11;11;11;11;11;11;11;11;11;11;11;11;11;11;11;11;11;11;11;11;11;11;11;11;11;11;11;11;5;5;5;5;5;5;5;2;2;4;1;1;1;1;1;1;1;1;1;1;1;1;
11;11;11;11;11;11;11;11;11;11;11;11;11;11;11;11;11;11;11;11;11;11;11;11;11;11;11;11;5;5;5;5;5;5;5;2;2;2;1;1;1;1;1;1;1;1;1;1;1;1;
11;11;11;11;11;11;11;11;11;11;11;11;11;11;11;11;11;11;11;11;11;11;11;11;11;11;11;11;11;5;5;5;5;5;5;6;2;2;4;1;1;1;1;1;1;1;1;1;1;1;
11;11;11;11;11;11;11;11;11;11;11;11;11;11;11;11;11;11;11;11;11;11;11;11;11;11;11;11;11;11;11;5;5;5;5;5;2;2;2;4;1;1;1;1;1;1;1;1;1;1
